    #####
    #   #
    #   #
  ###  $##
  #  $ $ #
### # ## #   ######
#   # ## #####   .#
# $  $          ..#
##### ### #@##  ..#
    #     #########
    #######