    #####
    #   #
    #   #
  ###   ##
  #  $ $ #
### # ## #   ######
#   # ## #####    #
# $  $          ..#
##### ### #@##  ..#
    #     #########
    #######