###################################
a                                  #
#+                          #      #
##     ##############  #           #
##     #        #          #       #
##                   #             #
##     #          #                #
##          #                 #    #
##                   ###############
##    #       #                    #
##             #                   #
##              ##########  #      #
##      #     #   #                #
##           #                     #
##           #                     #
##           #       ###############
##           #                     #
##          #                      #
###############################    #
##                                 #
#      ^                           #
#                                  #
####################################