###################################
#                                  #
#                           #      #
##     ##############  #           #
##     #        #          #       #
##     #             #             #
##     #####      #                #
##          #                 #    #
##           #       ###############
##    #       #                    #
##             #                   #
##              ##########  #      #
##      #     #   #                #
##           #                     #
##           #                     #
##    +      #       ###############
##           #                     #
##          #                      #
###############################    #
##                                 #
#      ^                           #
#                                  #
####################################