    ##### 
  ###   ##
  #   $  #
### # ## #   ######
#   # ## #####    #
# $              .#
##### ### #@##   .#
    #     #########
    ####### 