#######################
#                     #
# ################## ##
# #.. #            #  #
# #   # $$       # #  #
# #             #     #
# #   #          # #  #
# #   # #      #    ###
# #################   #
#@                    #
#######################
