#######################
#                     #
# ################## ##
# #...#            #  #
# #.  # $$$$     # #  #
# #             #     #
# #   #          # #  #
# #   # #      #    ###
# #################   #
#@                    #
#######################
