    #####
    #   #
    #   #
  ###   ##
  #    $ #
### # ## #   ######
#   # ## #####    #
# $  $           .#
##### ### #@##  ..#
    #     #########
    ####### 